12
************
*S         *
* ******** *
* * * *     
* * X  X * *
* * * *     
* ******** *
* * * *     
* * E   * * 
* * X * *   
* * F *     
************