10
**********
*S   *   *
* ** * * *
* *  * * *
* * **   *
* *    * *
* **** * *
*    E   *
*   *   F*
**********
