10
**********
*S       *
* ***** * 
* * X    *
* * *     
* * E    *
* ****** *
* *       
* F *     
**********